youtuber name,channel name,Category,Subscribers,Audience Country,avg views,avg likes,avg comments,Authenticengagement
tseries,T-Series,Music & Dance,212100000,India,323700,9800,290,333790
PewDiePie,PewDiePie,Animation,111400000,United States,1400000,80800,4600,1485400
MrBeast6000,MrBeast,Video games,92500000,United States,30600000,1700000,67700,32367700
WWEFanNation,WWE,Video games,86900000,United States,76600,2800,163,79563
zeemusiccompany,Zee Music Company,Music & Dance,82700000,India,108700,4200,155,113055
kidrauhl,Justin Bieber,Music & Dance,68100000,United States,2700000,162700,7900,2870600
CanalKondZilla,Canal KondZilla,Music & Dance,65500000,Brazil,36800,2300,153,39253
BANGTANTV,BANGTANTV,Music & Dance,65000000,United States,2800000,598900,14200,3413100
sabtv,Sony SAB,Movies,64900000,India,46500,899,27,47426
ibighit,HYBE LABELS,Music & Dance,64700000,United States,401700,62300,2600,466600
filmigaane,Shemaroo Filmi Gaane,Music & Dance,59200000,India,64500,631,33,65164
corycotton,Dude Perfect,Video games,57400000,United States,10300000,375700,9100,10684800
Marshmello,Marshmello,Music & Dance,55000000,United States,636000,47400,4900,688300
BHOJPURIWAVE,Wave Music,Music & Dance,51500000,India,85800,1400,155,87355
aajtaktv,Aaj Tak,News & Politics,50900000,India,8900,128,10,9038
sonymusicindiaSME,Sony Music India,Music & Dance,50300000,India,60200,2600,75,62875
tipsmusic,Tips Official,Music & Dance,49900000,India,230800,1800,85,232685
tseriesbhakti,T-Series Bhakti Sagar,Music & Dance,48300000,India,26400,1200,73,27673
JuegaGerman,JuegaGerman,Animation,45500000,Mexico,1400000,140700,4800,1545500
yrf,YRF,Music & Dance,45300000,India,184200,5500,104,189804
Billie Eilish,Billie Eilish,Music & Dance,45100000,United States,1300000,149700,7200,1456900
whinderssonnunes,whinderssonnunes,Movies,43800000,Brazil,140800,17000,145,157945
BRIGHT SIDE,BRIGHT SIDE,Animation,43200000,United States,79700,1900,137,81737
KatyPerryMusic,Katy Perry,Music & Dance,42600000,United States,151600,10700,824,163124
infobellshindirhymes,Infobells - Hindi,Education,42600000,India,883300,4700,0,888000
DjWalkzz,Alan Walker,Music & Dance,41600000,United States,146700,12900,378,159978
sonymusicindiaVEVO,SonyMusicIndiaVEVO,Music & Dance,41200000,India,2300,136,19,2455
speedrecordss,Speed Records,Music & Dance,40000000,India,42300,1800,79,44179
A4,A4,Animation,39000000,Russia,12300000,650500,43900,12994400
gr6explode,GR6 EXPLODE,Music & Dance,37200000,Brazil,179600,11400,190,191190
luccasneto,LUCCAS NETO - LUCCAS TOON,Animation,37100000,Brazil,625700,13300,0,639000
venus,Ishtar Music,Music & Dance,36500000,India,67800,790,59,68649
Kimberly Loaiza,Kimberly Loaiza,Daily vlogs,36000000,Mexico,9200000,646500,42300,9888800
DaddyYankeeOFFTV,Daddy Yankee,Music & Dance,35800000,Argentina,1700000,174600,15800,1890400
Voot Kids,Voot Kids,Movies,35800000,India,2400000,17200,0,2417200
shfa,shfa,Daily vlogs,34900000,France,3600000,52400,0,3652400
JbalvinTube,J Balvin,Music & Dance,33299999,Colombia,0,0,0,0
vegetta777,VEGETTA777,Video games,32900000,Mexico,394200,31700,256,426156
Goldmines Gaane Sune Ansune,Goldmines Gaane Sune Ansune,Music & Dance,32700000,India,65700,515,22,66237
markiplierGAME,Markiplier,Animation,32500000,United States,3000000,165300,6000,3171300
abpnewstv,ABP NEWS,News & Politics,32100000,India,2600,35,3,2638
NoCopyrightSounds,NoCopyrightSounds,Music & Dance,32100000,United States,535500,19700,1200,556400
Desi Music Factory,Desi Music Factory,Music & Dance,32100000,India,10800000,396400,143600,11340000
Geet MP3,Geet MP3,Music & Dance,31900000,India,381400,25800,1000,408200
tseriesapnapunjab,T-Series Apna Punjab,Music & Dance,31300000,India,34300,1400,64,35764
SSSniperWolf,SSSniperWolf,Humor,31000000,United States,4900000,141900,7300,5049200
Mikecrack,Mikecrack,Animation,30900000,Mexico,3800000,277400,9600,4087000
GENIAL,GENIAL,Animation,30900000,Mexico,74300,2400,83,76783
AllTrapNation,Trap Nation,Music & Dance,30500000,United States,129300,4700,136,134136
IndiaTV,IndiaTV,News & Politics,30500000,India,13600,219,11,13830
SMTOWN,SMTOWN,Music & Dance,30200000,United States,478000,54700,3200,535900
Ricis Official,Ricis Official,Music & Dance,29700000,Indonesia,782000,51600,1800,835400
rezendeevil,rezendeevil,Video games,29700000,Brazil,230700,28700,463,259863
AH,AH,Music & Dance,29600000,Indonesia,1400000,81100,4400,1485500
SpinninRec,Spinnin' Records,Music & Dance,29500000,United States,70300,2500,71,72871
latenight,The Tonight Show Starring Jimmy Fallon,Music & Dance,29300000,United States,88800,2200,121,91121
tseriesoldisgold,Bollywood Classics,Music & Dance,28900000,India,44400,530,39,44969
DisneyMusicVEVO,DisneyMusicVEVO,Music & Dance,28500000,United States,2500000,63200,2000,2565200
UltraRecords,Ultra Music,Music & Dance,28300000,United States,30600,1200,48,31848
jacksepticeye,jacksepticeye,Video games,28200000,United States,1900000,127600,5200,2032800
xoxxxoooxo,The Weeknd,Music & Dance,27700000,United States,355600,25300,1100,382000
TheLateLateShow,The Late Late Show with James Corden,Animation,27500000,United States,78100,1600,112,79812
ImagineDragons,ImagineDragons,Music & Dance,27500000,United States,1600000,95800,3600,1699400
WWRBhojpuri,Worldwide Records Bhojpuri,Music & Dance,26700000,India,119600,1700,129,121429
SongsOfIndianCinema,Saregama Music,Music & Dance,26600000,India,31600,906,79,32585
MrBeast Gaming,MrBeast Gaming,Animation,26500000,United States,23300000,732000,44000,24076000
TheDonato,TheDonato,Video games,26500000,Mexico,488100,56500,240,544840
TheDiamondMinecart,DanTDM,Video games,26100000,United States,1300000,59500,3700,1363200
taylorgangent,Wiz Khalifa,Music & Dance,26000000,United States,0,0,0,0
WorldStarHipHopTV,WORLDSTARHIPHOP,Music & Dance,25800000,United States,72700,2400,267,75367
VanossGaming,VanossGaming,Animation,25600000,United States,1200000,57500,624,1258124
enchufetv,enchufetv,Humor,25600000,Ecuador,960600,99900,235,1060735
LosPolinesios,LosPolinesios,Daily vlogs,25400000,Mexico,620900,45600,997,667497
PowerKids,PowerKids,Movies,25300000,India,18900,0,0,18900
smosh,Smosh,Animation,25000000,United States,193400,10800,382,204582
xSkyHeLLxx,Renato Garcia,Toys,24800000,Brazil,1000000,112200,1500,1113700
AboFlah,AboFlah,Animation,24700000,Iraq,0,0,0,0
zeenews,Zee News,News & Politics,24500000,India,78300,1300,80,79680
WatchMojo,WatchMojo.com,Movies,24400000,United States,77700,2300,231,80231
Jess No Limit,Jess No Limit,Music & Dance,24400000,Indonesia,363200,15400,1100,379700
TwiNboTzVids,Lucas and Marcus,Animation,24400000,United States,472400,20300,749,493449
jypentertainment,JYP Entertainment,Music & Dance,24200000,United States,2300000,455200,18400,2773600
James Charles,James Charles,Beauty,24200000,United States,1000000,54800,2200,1057000
davidguettavevo,David Guetta,Music & Dance,24000000,Brazil,267400,8700,358,276458
ZHC,ZHC,Design/art,23800000,United States,5200000,195600,8900,5404500
adityamusic,Aditya Music,Music & Dance,23600000,India,49000,1200,36,50236
Logan Paul,Logan Paul,Video games,23400000,United States,4300000,76200,3900,4380100
Rans Entertainment,Rans Entertainment,Music & Dance,23400000,Indonesia,755700,22900,675,779275
NewOnNetflix,Netflix,Movies,23200000,United States,265200,5000,325,270525
Chloe Ting,Chloe Ting,Fitness,23200000,United States,375700,17300,783,393783
Troom Troom,Troom Troom,Toys,23000000,United States,339200,3700,107,343007
Raffy Tulfo in Action,Raffy Tulfo in Action,Music & Dance,23000000,Philippines,399400,5800,773,405973
JellyYT,Jelly,Video games,22800000,United States,260000,13200,450,273650
ColdplayVEVO,Coldplay,Music & Dance,22800000,United States,66200,6900,188,73288
Mister Max,Mister Max,DIY & Life Hacks,22600000,Russia,988200,22400,879,1011479
DrossRotzank,DrossRotzank,News & Politics,22400000,Mexico,2100000,151600,8100,2259700
Sandeep Maheshwari,Sandeep Maheshwari,Daily vlogs,22400000,India,652600,38800,2300,693700
ABP NEWS HINDI,ABP NEWS HINDI,News & Politics,22300000,India,2000,25,6,2031
THECHAINSMOKERS,The Chainsmokers,Humor,22200000,United States,62400,6200,97,68697
netdmuzikk,netd m√ºzik,Music & Dance,22000000,Turkey,15500,355,59,15914
gmmgrammyofficial,GMM GRAMMY OFFICIAL,Music & Dance,21700000,Thailand,2400,53,2,2455
Anuel AA,Anuel AA,Music & Dance,21600000,Colombia,104200,7400,373,111973
Miss Katy,Miss Katy,Video games,21400000,Russia,604800,11200,626,616626
Frost Diamond,Frost Diamond,Music & Dance,21200000,Indonesia,395100,21300,1200,417600
Tasty,Tasty,Food & Drinks,21000000,United States,251500,7900,239,259639
WHBBP,White Hill Music,Music & Dance,21000000,India,23200,1200,89,24489
oRugrat,FaZe Rug,Video games,20800000,United States,2500000,105900,5900,2611800
5-Minute Crafts DIY,5-Minute Crafts DIY,Music & Dance,20800000,India,53400,648,18,54066
CanalCanalha,CanalCanalha,Sports,20700000,Brazil,1100000,127400,2100,1229500
hamaarbhojiwood,Wave Music Bhojpuri,Music & Dance,20600000,India,8800,139,30,8969
The Lallantop,The Lallantop,News & Politics,20500000,India,12900,313,50,13263
FGTeeV,FGTeeV,Animation,20400000,United States,2100000,23500,2100,2125600
BuzzFeedVideo,BuzzFeedVideo,Daily vlogs,20400000,United States,56000,1400,148,57548
Baim Paula,Baim Paula,Music & Dance,20400000,Indonesia,1100000,49800,1900,1151700
SSundee,SSundee,Video games,20400000,United States,3000000,141200,4600,3145800
AuthenticGames,AuthenticGames,Video games,20200000,Brazil,64800,6100,229,71129
TheFineBros,REACT,Humor,20200000,United States,89500,3000,382,92882
VEVO,Vevo,Music & Dance,20000000,United States,85600,804,36,86440
SlivkiChanel,SlivkiShow,DIY & Life Hacks,19800000,Russia,2800000,295000,55300,3150300
LazarBeam,LazarBeam,Video games,19800000,United States,4200000,160000,5900,4365900
BeckyGOfficial,Becky G,Music & Dance,19800000,United States,57500,5000,126,62626
NewAFI2013,Indosiar Visual Mandiri,Music & Dance,19600000,Indonesia,15700,264,22,15986
rossbollinger,Pencilmation,Animation,19600000,United States,390900,3400,96,394396
PrestonPlayz,Preston,Animation,19400000,United States,2800000,68600,3600,2872200
Mnet,Mnet K-POP,Music & Dance,19400000,United States,31100,2600,112,33812
CharliesVlogs,Charlie Puth,Music & Dance,19200000,United States,464700,34000,802,499502
Totoy kids - Portugu√™s,Totoy kids - Portugu√™s,Toys,19200000,Brazil,207400,1500,0,208900
RotanaAudio,Rotana,Music & Dance,19200000,Saudi Arabia,1300000,22000,533,1322533
Crafty Panda,Crafty Panda,Music & Dance,19100000,India,75000,540,15,75555
Noor Stars,Noor Stars,Music & Dance,19100000,Iraq,2000000,161300,12100,2173400
DLS News,DLS News,News & Politics,19000000,India,74300,2500,146,76946
Troom Troom Es,Troom Troom Es,Toys,19000000,Mexico,120500,2700,58,123258
The ACE Family,The ACE Family,Humor,19000000,United States,1400000,73800,3600,1477400
gordonramsay,Gordon Ramsay,Food & Drinks,18800000,United States,218100,7200,338,225638
TelenovelaTelevisa,Tlnovelas,ASMR,18800000,Mexico,26800,310,13,27123
Infinite,Infinite,Video games,18800000,United States,528700,24300,1900,554900
MrVivekBindra,Dr. Vivek Bindra: Motivational Speaker,Education,18800000,India,290000,18200,222,308422
TheWillyrex,TheWillyrex,Video games,18600000,Spain,35100,2400,0,37500
fatosdesconhecidos,Fatos Desconhecidos,Science & Technology,18600000,Brazil,242100,23100,636,265836
OfficialClashOfClans,Clash of Clans,News & Politics,18400000,United States,485900,16100,280,502280
JimmyKimmelLive,Jimmy Kimmel Live,Movies,18400000,United States,202900,4900,288,208088
MARVEL,Marvel Entertainment,Movies,18400000,United States,347200,26300,1000,374500
RobinHoodGamer1,Robin Hood Gamer,Animation,18400000,Brazil,1300000,59000,1100,1360100
Unbox Therapy,Unbox Therapy,Science & Technology,18200000,United States,1300000,17700,2000,1319700
NBA,NBA,Sports,18200000,United States,49400,1600,92,51092
Kurzgesagt,Kurzgesagt ‚Äì In a Nutshell,Education,18200000,United States,7700000,354700,15700,8070400
gmapublicaffairs,GMA Public Affairs,News & Politics,18100000,Philippines,10600,131,10,10741
sonotekvideo,Sonotek,Music & Dance,18000000,India,34100,1200,127,35427
GEN HALILINTAR,GEN HALILINTAR,Music & Dance,18000000,Indonesia,747500,39900,726,788126
INCR√çVEL,INCR√çVEL,Animation,17800000,Brazil,32500,1800,47,34347
DanielSaboya,Dan-Sa / Daniel Saboya,Music & Dance,17800000,Brazil,33900,1600,20,35520
TheOdd1sOut,TheOdd1sOut,Animation,17700000,United States,0,0,0,0
Ninja Kidz TV,Ninja Kidz TV,Video games,17600000,United States,2500000,22400,1100,2523500
Brent Rivera,Brent Rivera,Animation,17600000,United States,3900000,281500,11500,4193000
TheGrefg,TheGrefg,Animation,17500000,Spain,1400000,97000,1500,1498500
Matroix,Ali-A,Video games,17500000,United States,691200,20100,847,712147
HiMan,HiMan,Video games,17500000,Russia,1200000,102300,351,1302651
rhettandlink2,Good Mythical Morning,Food & Drinks,17500000,United States,1300000,40200,1400,1341600
CookieSwirlC,CookieSwirlC,Video games,17500000,United States,411800,4700,842,417342
ElTrollino,ElTrollino,Animation,17500000,Mexico,3300000,101000,2500,3403500
Naisa Alifia Yuriza (N.A.Y),Naisa Alifia Yuriza (N.A.Y),Music & Dance,17500000,Indonesia,504700,19900,757,525357
MiawAug,MiawAug,Video games,17300000,Indonesia,1300000,67300,4900,1372200
rsiammusic,RsiamMusic : ‡∏≠‡∏≤‡∏£‡πå‡∏™‡∏¢‡∏≤‡∏°,Music & Dance,17300000,Thailand,8400,306,10,8716
Emiway Bantai,Emiway Bantai,Music & Dance,17300000,India,864400,106600,7300,978300
Netflix India,Netflix India,ASMR,17300000,India,61900,2800,72,64772
farrukotv,Farruko,Music & Dance,17300000,United States,493200,22300,807,516307
dj47maryn,Marmok,Video games,17300000,Russia,3800000,437500,15100,4252600
portadosfundos,Porta dos Fundos,Movies,17300000,Brazil,639800,62800,808,703408
Willyrex,Willyrex,Video games,17100000,Mexico,147500,10000,96,157596
SCTVIndonesia,Surya Citra Televisi,Music & Dance,17100000,Indonesia,23600,433,39,24072
SebastianYatra,Sebasti√°n Yatra,Music & Dance,17100000,Colombia,1800000,55500,1200,1856700
ThePoznavatel,–ü–æ–∑–Ω–∞–≤–∞—Ç–µ–ª—å,Toys,16900000,Russia,3400000,92300,3200,3495500
RobleisIUTU,RobleisIUTU,Animation,16900000,Argentina,1200000,79300,2300,1281600
The Royalty Family,The Royalty Family,Humor,16700000,United States,2800000,81700,10700,2892400
musicalrmastv,ÿßŸÑŸÄÿ±ŸäŸÖÿßÿ≥ - Al-Remas,Music & Dance,16700000,Iraq,66500,3300,166,69966
grammygoldofficia,Grammy Gold Official,Music & Dance,16700000,Thailand,12100,198,19,12317
IGNentertainment,IGN,Movies,16500000,United States,65800,1500,150,67450
TEDEducation,TED-Ed,Science & Technology,16500000,United States,330200,15100,633,345933
JasonDerulo,Jason Derulo,Music & Dance,16500000,United States,73900,5200,81,79181
Tu COSMOPOLIS,Tu COSMOPOLIS,Daily vlogs,16500000,Mexico,211100,17100,1200,229400
jquintanac5,DeToxoMoroxo,Movies,16500000,Mexico,835100,37500,10600,883200
LankyBox,LankyBox,Video games,16500000,United States,1100000,15200,500,1115700
invictorgs3,invictor,Video games,16399999,Mexico,2900000,97400,2200,2999600
TheBrianMaps,TheBrianMaps,Video games,16300000,Russia,2600000,314600,12700,2927300
Rafa & Luiz,Rafa & Luiz,Video games,16300000,Brazil,579700,39200,1400,620300
SUPER SLICK SLIME SAM,SUPER SLICK SLIME SAM,DIY & Life Hacks,16200000,Mexico,228200,7300,268,235768
Jane ASMR Ï†úÏù∏,Jane ASMR Ï†úÏù∏,Daily vlogs,16100000,United States,438700,8600,498,447798
AnittaOficial,Anitta,Music & Dance,16100000,Brazil,316400,12300,488,329188
jeffreestar,jeffreestar,Beauty,16100000,United States,878500,36700,3200,918400
Canal IN,Canal IN,Toys,16100000,Brazil,26200,1600,16,27816
iberethenorio,Manual do Mundo,Science & Technology,16100000,Brazil,488800,69800,740,559340
Antrax,Antrax,Video games,16100000,Mexico,935800,88100,543,1024443
zbingzbing,zbing z.,Animation,15900000,Thailand,657300,26300,1100,684700
Kiddiestv Hindi - Nursery Rhymes & Kids Songs,Kiddiestv Hindi - Nursery Rhymes & Kids Songs,Education,15900000,United States,67300,507,0,67807
littlemixmusic,Little Mix,Music & Dance,15900000,United States,104200,10000,160,114360
Kaykai Salaider,Kaykai Salaider,Movies,15700000,Thailand,1400000,104000,8200,1512200
boyceavenue,Boyce Avenue,Music & Dance,15700000,Brazil,338500,8000,355,346855
failarmy,FailArmy,Animation,15700000,United States,2200000,19900,642,2220542
DopeLyrics,DopeLyrics,Music & Dance,15700000,United States,31700,615,50,32365
DUDU e CAROL,DUDU e CAROL,Toys,15700000,Brazil,1400000,65900,142,1466042
queenofficial,Queen Official,Music & Dance,15700000,United States,123300,4200,491,127991
movieclipsTRAILERS,Movieclips Trailers,Movies,15700000,United States,58200,903,74,59177
MatthewPatrick13,The Game Theorists,Science & Technology,15700000,United States,3100000,163800,8200,3272000
Khan GS Research Centre,Khan GS Research Centre,Education,15600000,India,9100000,641500,44700,9786200
TRANSTVofficial,TRANS TV Official,Music & Dance,15500000,Indonesia,373,5,0,378
SonyMusicSouthVEVO,SonyMusicSouthVEVO,Music & Dance,15500000,India,110200,4100,40,114340
RomanAtwoodVlogs,Roman Atwood Vlogs,Humor,15500000,United States,677400,33800,1200,712400
marquesbrownlee,Marques Brownlee,Science & Technology,15500000,United States,2900000,119200,6500,3025700
vice,VICE,News & Politics,15500000,United States,257500,5600,767,263867
Aayu and Pihu Show,Aayu and Pihu Show,Movies,15500000,India,4300000,111300,7700,4419000
tanboy kun,tanboy kun,Music & Dance,15400000,Indonesia,2200000,56800,2000,2258800
Triggered Insaan,Triggered Insaan,Humor,15400000,India,6400000,800900,26500,7227400
monstafluffmusicTV,7clouds,Music & Dance,15300000,United States,185400,3000,140,188540
Dyland PROS,Dyland PROS,Music & Dance,15300000,Indonesia,92100,7700,448,100248
Camila Cabello,Camila Cabello,Music & Dance,15300000,United States,109400,14200,146,123746
JenniferLopez,Jennifer Lopez,Fashion,15300000,United States,401900,12100,1200,415200
MegatoadStonie,Matt Stonie,Food & Drinks,15300000,United States,0,0,0,0
AdMe.ru - –°–∞–π—Ç –æ —Ç–≤–æ—Ä—á–µ—Å—Ç–≤–µ,AdMe.ru - –°–∞–π—Ç –æ —Ç–≤–æ—Ä—á–µ—Å—Ç–≤–µ,Animation,15300000,Russia,51900,1500,83,53483
Ivana Alawi,Ivana Alawi,Daily vlogs,15300000,Philippines,2700000,122600,11000,2833600
portalfitdance,FitDance,Music & Dance,15100000,Brazil,46300,1300,23,47623
Kerajinan 5-Menit,Kerajinan 5-Menit,Music & Dance,15100000,Indonesia,20800,221,10,21031
TheRichest,TheRichest,News & Politics,15100000,United States,17300,588,45,17933
popchartbusters,Pop Chartbusters,Music & Dance,15100000,India,20200,366,21,20587
OGatoGalactico,Gato Galactico | GAL√ÅXIA,Toys,15100000,Brazil,79600,4700,106,84406
wifistudy,wifistudy,Education,15000000,India,7400,645,15,8060
ntvru,–ù–¢–í,News & Politics,15000000,Russia,82300,901,216,83417
Dhar Mann,Dhar Mann,Health & Self Help,15000000,United States,6200000,140900,6300,6347200
KSIOlajidebtHD,JJ Olatunji,Animation,14900000,United States,4800000,429500,9600,5239100
kwebbelkop,Kwebbelkop,Animation,14900000,United States,218800,17500,882,237182
RCTI - LAYAR DRAMA INDONESIA,RCTI - LAYAR DRAMA INDONESIA,Music & Dance,14900000,Indonesia,26100,455,23,26578
ranziscool,Ranz Kyle,Humor,14900000,Philippines,362300,15000,507,377807
Makiman131,Makiman131,Video games,14900000,Spain,393800,25400,795,419995
Lachlan,Lachlan,Video games,14900000,United States,864600,34600,935,900135
IISuperwomanII,Lilly Singh,Animation,14700000,United States,94800,6600,103,101503
TalkingFriends,Talking Tom & Friends,Animation,14700000,United States,445800,4300,0,450100
CanalTaBombando,LEGENDA FUNK,Music & Dance,14700000,Brazil,9300,529,22,9851
Planeta das G√™meas,Planeta das G√™meas,Toys,14700000,Brazil,531200,23200,22,554422
AMARINTV : ‡∏≠‡∏°‡∏£‡∏¥‡∏ô‡∏ó‡∏£‡πå‡∏ó‡∏µ‡∏ß‡∏µ,AMARINTV : ‡∏≠‡∏°‡∏£‡∏¥‡∏ô‡∏ó‡∏£‡πå‡∏ó‡∏µ‡∏ß‡∏µ,News & Politics,14600000,Thailand,13100,148,21,13269
News24page,News24,News & Politics,14500000,India,9500,186,19,9705
Niana Guerrero,Niana Guerrero,Music & Dance,14500000,Philippines,732400,41000,1600,775000
Drawblogs,Drawblogs,Movies,14500000,Mexico,0,0,0,0
Sidemen,Sidemen,Video games,14500000,United Kingdom,5900000,276400,9500,6185900
zncoficial,Z√© Neto e Cristiano,Music & Dance,14500000,Brazil,5300000,44000,643,5344643
rkddigital,RKD Studios,Movies,14500000,India,42600,870,39,43509
hejproducao,Henrique e Juliano,Music & Dance,14500000,Brazil,96800,4100,75,100975
MattyBRaps,MattyBRaps,Music & Dance,14500000,United States,512600,8000,413,521013
collegehumor,CollegeHumor,Humor,14500000,United States,194600,8400,360,203360
popskids,POPS Kids,Animation,14500000,Poland,15900,61,0,15961
La Rosa de Guadalupe,La Rosa de Guadalupe,Animation,14500000,Mexico,361000,3200,81,364281
LinusTechTips,Linus Tech Tips,Science & Technology,14500000,United States,1500000,63500,2500,1566000
T3DDYgames,T3ddy,Daily vlogs,14400000,Brazil,1100000,140100,5600,1245700
XpressTV,XpressTV,Science & Technology,14300000,Mexico,1500000,62200,764,1562964
Harsh Beniwal,Harsh Beniwal,Movies,14300000,India,11600000,1300000,55400,12955400
chadwildclay,Chad Wild Clay,Movies,14300000,United States,2300000,43800,7400,2351200
iTownGamePlay,iTownGamePlay *Terror&Diversi√≥n*,News & Politics,14300000,Mexico,131200,6200,340,137740
MartinGarrix,Martin Garrix,Music & Dance,14300000,United States,59600,1900,125,61625
Canal Nostalgia,Canal Nostalgia,Science & Technology,14300000,Brazil,265100,36800,536,302436
theslowmoguys,The Slow Mo Guys,Education,14300000,United States,1200000,72700,3200,1275900
LEGO,LEGO,Design/art,14300000,United States,21500,84,0,21584
mkmusicnews,MK MUSIC,Music & Dance,14200000,Brazil,53300,2800,122,56222
Daftar Populer,Daftar Populer,News & Politics,14100000,Indonesia,139300,2900,224,142424
Mobile Legends: Bang Bang Official,Mobile Legends: Bang Bang Official,Movies,14100000,Indonesia,259300,2400,21,261721
OfficialTrapCity,Trap City,Music & Dance,14100000,United States,44400,1800,77,46277
camilaloures,Camila Loures,Food & Drinks,14100000,Brazil,310400,28200,456,339056
Genierock,Genierock,Music & Dance,14100000,Thailand,16500,340,20,16860
It's Mamix,It's Mamix,DIY & Life Hacks,14100000,Russia,2800000,276300,14900,3091200
Arif muhammad,Arif muhammad,Music & Dance,13900000,Indonesia,3000000,93500,3200,3096700
AM3NlC,AM3NlC,Food & Drinks,13900000,Brazil,215900,24500,266,240666
GMMTVSPOTLIKE,GMMTV OFFICIAL‚Äã‚Äã,Movies,13900000,Thailand,26500,779,29,27308
NikkieTutorials,NikkieTutorials,Design/art,13900000,United States,821100,55700,2600,879400
MRamadanOfficial,Mohamed Ramadan I ŸÖÿ≠ŸÖÿØ ÿ±ŸÖÿ∂ÿßŸÜ,Music & Dance,13900000,Egypt,761500,28200,1800,791500
F2Freestylers,F2Freestylers - Ultimate Soccer Skills Channel,Sports,13900000,United Kingdom,208300,9400,111,217811
BollywoodClassics,Bollywood Classics,Music & Dance,13900000,India,40400,329,15,40744
WWWengie,Wengie,DIY & Life Hacks,13900000,United States,84800,5700,170,90670
thairathonline,Thairath Online,News & Politics,13900000,Thailand,25500,328,33,25861
Sourav Joshi Vlogs,Sourav Joshi Vlogs,Daily vlogs,13900000,India,6300000,571500,17000,6888500
TeamFilmsBhojpuri,Team Films Bhojpuri,Music & Dance,13800000,India,8200,229,46,8475
SOMOY TV,SOMOY TV,Daily vlogs,13800000,Bangladesh,8600,179,15,8794
bbchindi,BBC News Hindi,News & Politics,13700000,India,235700,0,336,236036
Zach Choi ASMR,Zach Choi ASMR,Daily vlogs,13700000,United States,765600,40000,1300,806900
MAIKI021,MAIKI021,Autos & Vehicles,13700000,Brazil,38500,5700,177,44377
Doc Tops,Doc Tops,News & Politics,13700000,Mexico,1400000,75700,2200,1477900
mispastelitosyoutub,Mis Pastelitos,Food & Drinks,13700000,Mexico,2300000,109600,3600,2413200
–¢—Ä—É–º –¢—Ä—É–º,–¢—Ä—É–º –¢—Ä—É–º,Humor,13700000,Russia,450800,6100,205,457105
vetealaversha,Darkar Company Studios,Animation,13700000,Mexico,416100,48800,678,465578
ndtvindia,NDTV India,News & Politics,13600000,India,20000,605,71,20676
dangmattsmith,Dang Matt Smith,Animation,13500000,United States,287900,9300,642,297842
zeefilmimusic,Zee Music Classic,Music & Dance,13500000,India,27700,205,22,27927
AzzyLand,AzzyLand,Animation,13500000,United States,198500,7300,455,206255
TWICE,TWICE,Music & Dance,13500000,Philippines,793700,78100,2600,874400
The World Adventures ‡§π‡§ø‡§®‡•ç‡§¶‡•Ä,The World Adventures ‡§π‡§ø‡§®‡•ç‡§¶‡•Ä,Daily vlogs,13500000,India,46700,2500,60,49260
NehaKakkarOfficial,Neha Kakkar,Music & Dance,13500000,India,0,0,0,0
Zach King,Zach King,Humor,13500000,United States,1200000,82300,1000,1283300
Daily Dose Of Internet,Daily Dose Of Internet,Animals & Pets,13500000,United States,4500000,265100,8600,4773700
laharimusic,Lahari Music | T-Series,Music & Dance,13500000,India,54900,2100,56,57056
TheABSCBNNews,ABS-CBN News,News & Politics,13400000,Philippines,4500,47,6,4553
CNN,CNN,News & Politics,13400000,United States,239200,3100,2900,245200
NOBRU,NOBRU,Video games,13300000,Brazil,109700,12200,285,122185
fcbarcelona,FC Barcelona,Sports,13300000,India,207500,13200,356,221056
crashcourse,CrashCourse,Science & Technology,13300000,United States,47600,1700,37,49337
UFC,UFC - Ultimate Fighting Championship,Sports,13300000,United States,155200,2900,347,158447
pognalishow,–î–∏–º–∞ –ú–∞—Å–ª–µ–Ω–Ω–∏–∫–æ–≤,Video games,13300000,Russia,4800000,436900,14300,5251200
TazerCraft,TazerCraft,Animation,13300000,Brazil,352800,26800,532,380132
RosannaPansino,Rosanna Pansino,Food & Drinks,13300000,United States,206000,8400,102,214502
Kuplinov ‚ñ∫ Play,Kuplinov ‚ñ∫ Play,Video games,13300000,Russia,1200000,67700,2500,1270200
EdisonPts,EdisonPts,Video games,13300000,Russia,2000000,153800,7600,2161400
MNCTVOfficial,MNCTV Official,Music & Dance,13200000,Indonesia,4100,126,6,4232
The LaBrant Fam,The LaBrant Fam,Music & Dance,13100000,United States,792500,25700,0,818200
Bizarrap,Bizarrap,Music & Dance,13100000,Argentina,80500000,5600000,313600,86413600
AtlanticVideos,Atlantic Records,Music & Dance,13100000,United States,9600,325,17,9942
CoryxKenshin,CoryxKenshin,Video games,13100000,United States,4700000,338800,20600,5059400
theRadBrad,theRadBrad,Video games,13100000,United States,186400,8800,613,195813
mymissanand,MyMissAnand,Movies,13100000,India,2100000,80900,1200,2182100
TV Ana Emilia,TV Ana Emilia,Fashion,13100000,Mexico,425600,14100,1400,441100
iloveindianmakeup,Anaysa,Humor,13100000,India,933600,38000,1400,973000
Auron,Auron,Video games,13100000,Mexico,2200000,137700,1700,2339400
Unspeakable,Unspeakable,Video games,13000000,United States,1900000,39300,2200,1941500
narendramodionline,NMF News,News & Politics,13000000,India,6200,123,18,6341
djzoi0,Everson Zoio,Humor,12900000,Brazil,631000,80100,2800,713900
50CentMusic,50 Cent,Music & Dance,12900000,United States,100700,5800,431,106931
News18 India,News18 India,News & Politics,12900000,India,2700,51,7,2758
MattSDance,Matt Steffanina,Music & Dance,12900000,United States,124500,7800,104,132404
SaturdayNightLive,Saturday Night Live,Movies,12900000,United States,1100000,19200,858,1120058
MrBeast Shorts,MrBeast Shorts,Daily vlogs,12900000,United States,0,0,0,0
SrtaLynaV,Lyna,Animation,12900000,Argentina,737100,37700,1700,776500
ChallengeAcceptedInc,Aphmau,Animation,12700000,United States,3900000,84600,4200,3988800
Aadishakti Films,Aadishakti Films,Music & Dance,12700000,India,39000,1400,152,40552
skillzaisherebooya,Conor Maynard,Music & Dance,12700000,United States,305800,21400,578,327778
twentyonepilots,twenty one pilots,Music & Dance,12700000,United States,1700000,153900,7200,1861100
ABCNews,ABC News,News & Politics,12700000,United States,12000,191,139,12330
DALLMYD,DALLMYD,Mystery,12700000,United States,322700,12400,735,335835
PozzitifonShow,–ü–æ–∑–∑–∏,Video games,12700000,Russia,1400000,87700,4700,1492400
1032010814,TKOR,DIY & Life Hacks,12700000,United States,107100,3800,256,111156
typicalgamer,Typical Gamer,Video games,12700000,United States,804400,14300,474,819174
123 GO! Spanish,123 GO! Spanish,Toys,12700000,Mexico,888000,11800,235,900035
Health Time,Health Time,Daily vlogs,12600000,India,12600,467,16,13083
Wish 107.5,Wish 107.5,Music & Dance,12600000,Philippines,146800,4400,372,151572
RedeTVhdBrasil,RedeTV,News & Politics,12600000,Brazil,2700,74,3,2777
NishaMadhulika,Nisha Madhulika,Food & Drinks,12500000,India,220600,5200,934,226734
Knowledge Tv ‡§π‡§ø‡§®‡•ç‡§¶‡•Ä,Knowledge Tv ‡§π‡§ø‡§®‡•ç‡§¶‡•Ä,Education,12500000,India,158700,9400,468,168568
JDCav24,ATHLEAN-X‚Ñ¢,Fitness,12500000,United States,395600,19000,693,415293
React,People Vs Food,Food & Drinks,12500000,United States,464200,18000,1000,483200
PrestonPlayz,PrestonPlayz,Video games,12500000,United States,2100000,48800,4000,2152800
BUDI01 GAMING,BUDI01 GAMING,Video games,12500000,Indonesia,1100000,91500,7100,1198600
MstrJames,Hacksmith Industries,DIY & Life Hacks,12500000,United States,896700,46300,1800,944800
JesseAndMike,JesseAndMike,Humor,12400000,United States,523799,6600,152,530551
Hongyu ASMR ÌôçÏú†,Hongyu ASMR ÌôçÏú†,ASMR,12300000,United States,1300000,15600,646,1316246
htpunjabi,Lokdhun Punjabi,Music & Dance,12300000,India,16200,346,8,16554
Piuzinho,Piuzinho,Video games,12300000,Brazil,233300,45800,625,279725
Meghan Trainor,Meghan Trainor,Music & Dance,12300000,United States,11400,564,35,11999
Juliana Baltar,Juliana Baltar,Toys,12300000,Brazil,286600,18600,335,305535
alanalan9635,Stokes Twins,Humor,12300000,United States,9900000,281500,19400,10200900
AdexeOficial,Adexe & Nau,Music & Dance,12300000,Mexico,38300,4400,367,43067
gymvirtual,gymvirtual,Music & Dance,12300000,Mexico,76400,3500,89,79989
einerdtv,Ei Nerd,Movies,12300000,Brazil,265400,42300,1200,308900
Alex Gonzaga Official,Alex Gonzaga Official,Music & Dance,12300000,Philippines,2900000,116600,2900,3019500
Gibby :),Gibby :),Daily vlogs,12300000,Mexico,582600,28400,1800,612800
Troom Troom PT,Troom Troom PT,Toys,12300000,Brazil,201400,4700,58,206158
jazzghost1,Jazzghost,Animation,12300000,Brazil,758700,55900,2000,816600
Bela Bagun√ßa,Bela Bagun√ßa,Toys,12300000,Brazil,74800,4400,148,79348
tseriesregional,T-Series Regional,Music & Dance,12100000,India,6900,148,18,7066
Brawl Stars,Brawl Stars,Animation,12100000,United States,6400000,181200,6900,6588100
Crescendo com Luluca,Crescendo com Luluca,Toys,12100000,Brazil,1300000,52800,4400,1357200
PowerfulJRE,PowerfulJRE,Daily vlogs,12100000,United States,498900,14700,1800,515400
bbcnews,BBC News,News & Politics,12100000,United Kingdom,236200,3300,1800,241300
NORMAN FAIT DES VID√âOS,NORMAN FAIT DES VID√âOS,Animation,12100000,France,1800000,168200,6900,1975100
awakeningrecords,Awakening Music,Music & Dance,12100000,Indonesia,16800,1200,60,18060
Zeinab Harake,Zeinab Harake,Daily vlogs,11900000,Philippines,1300000,71200,1800,1373000
HusamYK,Katakit Baby TV,Music & Dance,11900000,Saudi Arabia,179900,1600,0,181500
Migosatl,Migos ATL,Music & Dance,11900000,United States,3300000,131000,5300,3436300
TheDaniRep,DaniRep | +6 V√≠deos Diarios De GTA 5 Online!,Animation,11900000,Mexico,349900,19500,346,369746
colinfurze,colinfurze,DIY & Life Hacks,11900000,United States,1100000,36800,1100,1137900
Planet Earth INDIA,Planet Earth INDIA,Daily vlogs,11900000,India,459800,18100,460,478360
Dear Sir,Dear Sir,Education,11900000,India,261399,15600,1200,278199
officialjassrecords,Jass Records,Music & Dance,11800000,India,223800,3500,410,227710
–ì–õ–ï–ù–¢,–ì–õ–ï–ù–¢,Video games,11800000,Russia,3300000,281700,9500,3591200
Study IQ education,Study IQ education,Education,11700000,India,11400,519,12,11931
FrontaL Gaming,FrontaL Gaming,Animation,11700000,Indonesia,490800,35500,1800,528100
Blockbuster Movies,Blockbuster Movies,Daily vlogs,11700000,India,118500,1100,23,119623
AvrilLavigne,Avril Lavigne,Music & Dance,11700000,United States,2800000,130400,6500,2936900
Dani Russo Tv,Dani Russo Tv,Music & Dance,11700000,Brazil,10900,1400,121,12421
MORGENSHTERN,MORGENSHTERN,Humor,11700000,Russia,11000000,789900,54800,11844700
rebeccazamolo1,Rebecca Zamolo,Video games,11700000,United States,2800000,70600,6900,2877500
TommyInnit,TommyInnit,Animation,11700000,United States,3400000,294600,14400,3709000
Morgz,Morgz,Video games,11700000,United States,0,0,0,0
TheInfographicsShow,The Infographics Show,Education,11700000,United States,348800,10300,764,359864
1veritasium,Veritasium,Science & Technology,11700000,United States,3900000,169300,7800,4077100
hamaarbhojpuri,T-Series Hamaar Bhojpuri,Music & Dance,11700000,India,13500,177,17,13694
YOLO AVENTURAS,YOLO AVENTURAS,Daily vlogs,11600000,Colombia,838400,74900,7000,920300
TheDodoSite,The Dodo,Animals & Pets,11600000,United States,608900,22900,812,632612
Panda,Panda,Animation,11600000,India,1100000,103700,1900,1205600
Troom Troom Indonesia,Troom Troom Indonesia,Toys,11600000,Indonesia,256700,2500,96,259296
RaptorGamer,RaptorGamer,Video games,11500000,Mexico,741400,46500,1500,789400
CrazyRussianHacker,CrazyRussianHacker,DIY & Life Hacks,11500000,United States,75100,2300,139,77539
Codiscos,Codiscos,Music & Dance,11500000,Colombia,9400,195,7,9602
LIV Crime,LIV Crime,Daily vlogs,11500000,India,271600,2600,72,274272
hoiitsroi,Wassabi,Humor,11500000,United States,692400,47600,4800,744800
thinkmusicindia,Think Music India,Music & Dance,11500000,India,75400,3200,106,78706
BanderitaX,BanderitaX,Animation,11500000,Saudi Arabia,1400000,101200,3800,1505000
Americanvogue,Vogue,Fashion,11500000,United States,324200,13300,412,337912
luansantanaoficial,Luan Santana,Music & Dance,11500000,Brazil,3400000,54900,4700,3459600
FIFATV,FIFA,Sports,11500000,United States,63400,1900,152,65452
Davie504,Davie504,Music & Dance,11500000,United States,2000000,194400,1400,2195800
Mor Haryanvi,Mor Haryanvi,Music & Dance,11500000,India,3300000,49000,6300,3355300
ExpCaseros,ExpCaseros,DIY & Life Hacks,11500000,Spain,54100,2300,98,56498
TsMadaan,TsMadaan,Education,11500000,India,64099,1500,102,65701
ndtv,NDTV,News & Politics,11400000,India,4900,84,19,5003
Coke Studio,Coke Studio,Music & Dance,11300000,Pakistan,185300,5400,208,190908
DeGoBooM,DeGoBooM,Video games,11300000,Mexico,426000,16300,263,442563
htbhakti,Sonotek Bhakti,Music & Dance,11300000,India,101800,149,55,102004
MrTimbaVk,Timba Vk,Video games,11300000,Mexico,1500000,63800,1600,1565400
Yudist Ardhana,Yudist Ardhana,Video games,11300000,Indonesia,330400,11200,451,342051
elrubius,Rubius Z,Video games,11300000,Argentina,2300000,194600,2200,2496800
Trakin Tech,Trakin Tech,News & Politics,11300000,India,283100,21900,1100,306100
FelipeViktor,LipaoGamer,Animation,11300000,Brazil,164500,12400,168,177068
CaptainSparklez,CaptainSparklez,Video games,11300000,United States,111200,8000,436,119636
eltreceok,El Trece,News & Politics,11300000,Argentina,3600,40,7,3647
MTV2,Wild 'N Out,Music & Dance,11300000,United States,221000,4700,180,225880
DANIEL EL TRAVIESO VIDEOS,DANIEL EL TRAVIESO VIDEOS,Animation,11300000,Colombia,959700,32200,1200,993100
UnspeakableGaming,UnspeakableGaming,Video games,11300000,United States,857500,16500,783,874783
luzugames,luzugames,Video games,11300000,Mexico,0,0,0,0
lokdhuntv,Wave Music Bhakti,Music & Dance,11300000,India,7000,106,16,7122
gmanews,GMA News,News & Politics,11300000,Philippines,4900,50,12,4962
Sony Music South,Sony Music South,Music & Dance,11300000,India,265300,5500,135,270935
VyQwaint,Vy Qwaint,Video games,11200000,United States,2200000,43200,7000,2250200
KompasTVNews,KOMPASTV,News & Politics,11200000,Indonesia,5200,37,22,5259
Hero Movies 2022,Hero Movies 2022,Daily vlogs,11100000,India,177700,1200,22,178922
Rauw Alejandro,Rauw Alejandro,Music & Dance,11100000,Peru,0,0,0,0
123 GO!,123 GO!,Humor,11100000,United States,656000,5900,183,662083
TastyCompot,Compot,Video games,11100000,Russia,1700000,74400,2900,1777300
epicfortnite,Fortnite,Video games,11100000,United States,321300,10300,433,332033
Magic Five,Magic Five,Video games,11100000,Russia,4000000,230200,17100,4247300
FirstWeFeast,First We Feast,Food & Drinks,11100000,United States,308200,14100,689,322989
realannoyingorange,Annoying Orange,Animation,11100000,United States,121500,2800,361,124661
ElRinconDeGiorgio,El Rinc√≥n De Giorgio,Video games,11100000,Spain,1800000,170400,3100,1973500
ExplosmEntertainment,ExplosmEntertainment,Movies,11100000,United States,711200,45200,2200,758600
yogawithadriene,Yoga With Adriene,Fitness,11100000,United States,952000,19700,702,972402
Mo Vlogs,Mo Vlogs,Humor,11100000,India,401500,24200,909,426609
Star Casablanca | ŸÜÿ¨ŸàŸÖ ÿßŸÑÿØÿßÿ± ÿßŸÑÿ®Ÿäÿ∂ÿßÿ°,Star Casablanca | ŸÜÿ¨ŸàŸÖ ÿßŸÑÿØÿßÿ± ÿßŸÑÿ®Ÿäÿ∂ÿßÿ°,Music & Dance,11100000,Iraq,46500,2200,164,48864
BBCEarth,BBC Earth,Animals & Pets,11100000,United States,87700,2500,192,90392
Free Fire India Official,Free Fire India Official,Animation,11100000,India,177700,15600,821,194121
YMWayneCarter,Lil Wayne,Music & Dance,11100000,United States,2000000,100100,4800,2104900
coisadenerd,Coisa de Nerd,Design/art,11100000,Brazil,1100000,126100,3700,1229800
Alejo Igoa,Alejo Igoa,DIY & Life Hacks,11000000,Argentina,4099999,142200,4000,4246199
Simone e Simaria,Simone e Simaria,Music & Dance,10900000,Brazil,2400000,57200,1700,2458900
YoungBoy Never Broke Again,YoungBoy Never Broke Again,Music & Dance,10900000,United States,7600000,274700,23200,7897900
TheViralFeverVideos,The Viral Fever,Movies,10900000,India,1900000,89400,3000,1992400
hawkrecord,Single Track Studio,Music & Dance,10900000,India,989200,29800,439,1019439
mirandasings08,Miranda Sings,Humor,10900000,United States,153900,10300,1100,165300
watchcut,Cut,Humor,10900000,United States,409600,16900,762,427262
–õ—É–Ω–æ–º–æ—Å–∏–∫,–õ—É–Ω–æ–º–æ—Å–∏–∫,Video games,10900000,Russia,2500000,83900,2900,2586800
TygaTygaTV,Tyga,Music & Dance,10900000,United States,45600,3100,83,48783
comedycentral,Comedy Central,Humor,10900000,United States,42400,924,50,43374
DemolitionRanch,DemolitionRanch,Video games,10900000,United States,1600000,75400,5400,1680800
RapGeniusVideo,Genius,Music & Dance,10900000,United States,52100,2200,144,54444
E-MasterSensei,E-MasterSensei,Animation,10900000,Mexico,1500000,103200,1300,1604500
BakLol Video,BakLol Video,Movies,10900000,India,1400000,33400,1800,1435200
HellomaphieMX,HellomaphieMX,DIY & Life Hacks,10900000,Mexico,654400,76000,284,730684
jpgameplayfull,JP Plays,Video games,10900000,Brazil,112700,6000,207,118907
Dan Rhodes,Dan Rhodes,Animation,10800000,India,334100,29600,211,363911
geonews,Geo News,News & Politics,10800000,Pakistan,3800,53,5,3858
√Årea Secreta,√Årea Secreta,DIY & Life Hacks,10700000,Brazil,0,0,0,0
Virg√≠nia Fonseca,Virg√≠nia Fonseca,Daily vlogs,10700000,Brazil,922600,78600,1400,1002600
FilmTheorists,The Film Theorists,Movies,10700000,United States,2200000,110300,5500,2315800
GamesEduUu,Games EduUu,Movies,10700000,Brazil,1500000,218100,7700,1725800
ComedyShortsGamer,Deji,Animation,10700000,United Kingdom,1500000,50700,3200,1553900
HikakinTV,HikakinTV,Music & Dance,10700000,Japan,1200000,42600,1800,1244400
GoProCamera,GoPro,Sports,10700000,United States,55300,2100,59,57459
Slogomanify,Slogo,Video games,10700000,United States,387100,17800,424,405324
tomiii 11,tomiii 11,Daily vlogs,10700000,Mexico,78500,9700,445,88645
Narendra Modi,Narendra Modi,Science & Technology,10700000,India,31500,1800,133,33433
Dobre Brothers,Dobre Brothers,Humor,10700000,United States,284400,10200,381,294981
Experienced Mojaraba TV,Experienced Mojaraba TV,Health & Self Help,10700000,United States,190700,5200,128,196028
Jessica Jane,Jessica Jane,Food & Drinks,10500000,Indonesia,826400,46200,1100,873700
Ceylin - H Official,Ceylin - H Official,Music & Dance,10500000,Cyprus,73100,0,0,73100
stampylonghead,stampylonghead,Video games,10500000,United States,155900,8200,759,164859
Flamingo,Flamingo,Animation,10500000,United States,2100000,68300,7100,2175400
Golemcito Games,Golemcito Games,Video games,10500000,Peru,2800000,290000,6400,3096400
Vox,Vox,News & Politics,10500000,United States,2300000,69300,3600,2372900
francinyehlke,Franciny Ehlke,Fashion,10500000,Brazil,197200,19200,629,217029
BuzzFeedYellow,As/Is,Fashion,10500000,United States,27100,1100,12,28212
doctruyencotich,K√™nh Thi·∫øu Nhi - BHMEDIA,Music & Dance,10500000,United States,21300,94,0,21394
ChillStepNation,Chill Nation,Music & Dance,10500000,United States,53700,1100,46,54846
Acenix,Acenix,Video games,10500000,Mexico,2400000,111000,2200,2513200
SaraBeautyCorner,"SaraBeautyCorner - DIY, Comedy, Makeup, Nail Art",DIY & Life Hacks,10500000,United States,133300,7600,722,141622
WarnerBrosPictures,Warner Bros. Pictures,Movies,10500000,United States,424800,17700,861,443361
redbull,Red Bull,Sports,10500000,United States,292500,5200,246,297946
CJENMMUSIC,Stone Music Entertainment,Music & Dance,10500000,United States,8400,719,34,9153
brancoala,Brancoala,Toys,10500000,Brazil,398200,8200,202,406602
Sidhu Moose Wala,Sidhu Moose Wala,Music & Dance,10400000,India,3900000,336000,59000,4295000
AlArabiya,AlArabiya ÿßŸÑÿπÿ±ÿ®Ÿäÿ©,News & Politics,10400000,Morocco,6300,92,22,6414
MeKcanal,Matheus e Kauan,Music & Dance,10300000,Brazil,6200,663,11,6874
Jamuna TV,Jamuna TV,News & Politics,10300000,Bangladesh,60100,1500,96,61696
Cris Devil Gamer,Cris Devil Gamer,Music & Dance,10300000,United States,460500,19900,669,481069
prantoniojunior,Pastor Ant√¥nio J√∫nior,Music & Dance,10300000,Brazil,341000,79900,8800,429700
Pari's Lifestyle,Pari's Lifestyle,Daily vlogs,10300000,India,545600,12100,113,557813
HISHEdotcom,How It Should Have Ended,Movies,10300000,United States,903900,33900,1300,939100
penguinz0,penguinz0,Animation,10300000,United States,1400000,49300,2600,1451900
destinws2,SmarterEveryDay,Science & Technology,10300000,United States,1900000,72200,4700,1976900
cbstvdinsideedition,Inside Edition,News & Politics,10300000,United States,213100,5500,684,219284
Oum Walid,Oum Walid,Education,10300000,Algeria,527800,29400,1600,558800
Lofi Girl,Lofi Girl,Music & Dance,10300000,United States,96900,3800,179,100879
TwinRoozi ÏåçÎë•Ïù¥ Î£®ÏßÄ,TwinRoozi ÏåçÎë•Ïù¥ Î£®ÏßÄ,Daily vlogs,10300000,Indonesia,197500,0,0,197500
Mrwhosetheboss,Mrwhosetheboss,Science & Technology,10300000,United States,2700000,152900,10100,2863000
TikTak Draw,TikTak Draw,Science & Technology,10300000,Mexico,120900,7700,345,128945
sagahits,SagaHits,Music & Dance,10300000,India,45300,1200,51,46551
Sab kuchh sikho jano,Sab kuchh sikho jano,News & Politics,10200000,India,28800,1500,61,30361
Milena Stepanienco - MILENINHA,Milena Stepanienco - MILENINHA,Toys,10200000,Brazil,342500,2600,0,345100
Wylsacom,Wylsacom,News & Politics,10200000,Russia,946900,38800,6900,992600
aljazeerachannel,AlJazeera Channel ŸÇŸÜÿßÿ© ÿßŸÑÿ¨ÿ≤Ÿäÿ±ÿ©,News & Politics,10100000,Morocco,36700,485,89,37274
cleanbandit,Clean Bandit,Music & Dance,10100000,United States,64800,2100,100,67000
JessicaJulioeBaby,Laurinha e Helena - Clubinho da Laura,Toys,10100000,Brazil,246100,5700,176,251976
Rawan and Rayan,Rawan and Rayan,Daily vlogs,10100000,Algeria,1000000,61500,4400,1065900
TV9 Bharatvarsh,TV9 Bharatvarsh,News & Politics,10100000,India,27900,484,19,28403
AsapSCIENCE,AsapSCIENCE,Science & Technology,10100000,United States,772000,55800,1800,829600
DalasReview,Dalas Review,Science & Technology,10100000,Mexico,684700,82100,9700,776500
BE AMAZED,BE AMAZED,Education,10100000,United States,577000,14100,762,591862
0214mex,„ÅØ„Åò„ÇÅ„Åó„ÇÉ„Å°„Çá„ÉºÔºàhajimeÔºâ,Music & Dance,10100000,Japan,1200000,34200,1300,1235500
Republic Bharat,Republic Bharat,News & Politics,10100000,India,15400,0,17,15417
TomorrowlandChannel,Tomorrowland,Music & Dance,10100000,Brazil,19400,914,50,20364
VitalyzdTv,VitalyzdTv,Humor,10100000,United States,67900,1200,236,69336
–≤–î—É–¥—å,–≤–î—É–¥—å,News & Politics,10100000,Russia,16800000,615500,89400,17504900
atv,atv,Animation,10100000,Turkey,41200,420,25,41645
MTV,MTV,Music & Dance,10100000,United States,6700,343,23,7066
ctctv,–°–¢–°,Video games,10100000,Russia,19000,168,13,19181
Hindi Countdown,Hindi Countdown,Education,10100000,India,3600000,89600,3000,3692600
Lorrayne Oliveira,Lorrayne Oliveira,Toys,10100000,Brazil,281500,17500,502,299502
RDCGujarati,RDC Gujarati,Music & Dance,10000000,India,26100,808,26,26934
Juice WRLD,Juice WRLD,Music & Dance,10000000,United States,7600000,308300,19400,7927700
jordanmatter,Jordan Matter,Music & Dance,10000000,United States,4900000,137000,12500,5049500
whoisjimmy,How Ridiculous,Sports,9900000,United States,25500000,750300,5200,26255500
BestCodComedy,BCC Gaming,Video games,9900000,United States,2300,75,8,2383
makebymarimaria,Mari Maria,Fashion,9900000,Brazil,132100,13800,436,146336
Joe HaTTab,Joe HaTTab,Travel,9900000,Saudi Arabia,3500000,233200,15900,3749100
NASAtelevision,NASA,News & Politics,9900000,United States,92600,4200,0,96800
MSA previously My Story Animated,MSA previously My Story Animated,Animation,9900000,United States,5400000,154000,4800,5558800
Will Smith,Will Smith,Movies,9900000,United States,332200,10500,5500,348200
Heroine Movies 2022,Heroine Movies 2022,Daily vlogs,9900000,India,151900,1100,22,153022
shrutiarjunanand,Shruti Arjun Anand,Movies,9800000,India,1500000,47100,1500,1548600
barcroftmedia,truly,News & Politics,9800000,United States,105000,0,382,105382
panicopgm,Programa P√¢nico Lab,Toys,9800000,Brazil,22900,1100,27,24027
htv2channel,Vie Channel - HTV2,Music & Dance,9800000,United States,8500,114,7,8621
KiKiDo,KiKiDo,Video games,9800000,Russia,1700000,44000,1500,1745500
MBCkpop,MBCkpop,Music & Dance,9800000,Philippines,19000,925,87,20012
Receitas de Pai,Receitas de Pai,Food & Drinks,9800000,Brazil,99000,13000,336,112336
TheSyndicateProject,Syndicate,Video games,9800000,United States,157700,4900,1300,163900
Family Box,Family Box,Video games,9800000,Russia,510700,9700,483,520883
S∆°n T√πng M-TP Official,S∆°n T√πng M-TP Official,Music & Dance,9800000,United States,61200,4600,233,66033
OneRepublic,OneRepublic,Music & Dance,9700000,United States,9900,749,21,10670
BBCArabicNews,BBC News ÿπÿ±ÿ®Ÿä,News & Politics,9700000,Egypt,38500,736,145,39381
The Daily Show with Trevor Noah,The Daily Show with Trevor Noah,News & Politics,9700000,United States,497400,10200,1100,508700
Islam Populer,Islam Populer,Education,9700000,Indonesia,82300,2100,164,84564
Viki Show,Viki Show,Humor,9700000,Russia,2800000,109600,3100,2912700
Raditya Dika,Raditya Dika,Food & Drinks,9700000,Indonesia,179200,7800,299,187299
MrGustavoParodias,Gustavo Par√≥dias,Humor,9700000,Brazil,214500,22000,367,236867
singkingkaraoke,Sing King,Music & Dance,9700000,United States,10800,157,17,10974
EugenBro,EugenBro,Video games,9700000,Russia,724300,36500,2700,763500
ThePersica,Orkun I≈üƒ±tmak,Video games,9600000,Turkey,1700000,75500,2100,1777600
Prince Royce,Prince Royce,Music & Dance,9600000,United States,7000000,160800,3600,7164400
mainaCassette,Haryanvi Maina,Music & Dance,9600000,India,6300,55,4,6359
mamilosmolengas,Mussoumano,Music & Dance,9600000,Brazil,860500,88200,3600,952300
Sonotek Haryanvi,Sonotek Haryanvi,Music & Dance,9600000,India,11300,192,21,11513
Bispo Bruno Leonardo,Bispo Bruno Leonardo,Music & Dance,9600000,Brazil,577900,208700,139800,926400
bgfilms,Babish Culinary Universe,Food & Drinks,9600000,United States,817900,34400,1200,853500
ZarcortGame,ZarcortGame,Music & Dance,9500000,Mexico,111000,15300,538,126838
DELRECORDS,DEL Records,Music & Dance,9500000,Mexico,289000,12800,200,302000
ehbeefamily,The Bee Family,Humor,9500000,United States,58000,2600,170,60770
Ben Azelart,Ben Azelart,Video games,9500000,United States,2300000,89300,31100,2420400
Talent Recap,Talent Recap,Music & Dance,9500000,United States,33500,328,29,33857
Garena Free Fire Brasil,Garena Free Fire Brasil,Video games,9500000,Brazil,200900,3100,302,204302
InquisitorMaster,InquisitorMaster,Animation,9500000,United States,544300,20500,1300,566100
Niki and Gabi,Niki and Gabi,Fashion,9500000,United States,485500,25200,531,511231
TopMovieClips,TopMovieClips,Movies,9500000,United States,268300,5400,190,273890
timesmusicindia,Times Music,Music & Dance,9500000,India,456100,10300,178,466578
DaBaby,DaBaby,Music & Dance,9500000,United States,976400,36400,1300,1014100
IniTalkShow,Ini Talk Show,Music & Dance,9500000,Indonesia,0,0,0,0
BETO GAMER,BETO GAMER,Animation,9500000,Brazil,448900,28100,372,477372
MrStiven Tc,MrStiven Tc,Video games,9500000,Colombia,671700,66900,352,738952
NetflixBRA,Netflix Brasil,Humor,9400000,Brazil,23300,1600,90,24990
JoeyGraceffa,Joey Graceffa,Animals & Pets,9400000,United States,317900,23300,2900,344100
Grandpa Kitchen,Grandpa Kitchen,Food & Drinks,9400000,United States,162700,8600,318,171618
MrMuselk,Muselk,Video games,9400000,United States,465500,19600,636,485736
JoshDub,JoshDub,Animation,9400000,United States,0,0,0,0
N1Noobtubers,ÏõÉÏõÉTwinsFromRussia,Daily vlogs,9400000,India,55600,3600,19,59219
bhaktisongs,Shemaroo Bhakti,Music & Dance,9400000,India,2800,45,6,2851
The Voice Global,The Voice Global,Music & Dance,9400000,United States,320800,4100,87,324987
POPSVIETNAM,POPS MUSIC,Music & Dance,9400000,United States,7700,217,4,7921
CRACKS,CRACKS,Video games,9400000,Colombia,21300,2000,139,23439
efdewe,efdewe,Music & Dance,9300000,Indonesia,195000,11200,670,206870
sonotektv,Sonotek Music,Music & Dance,9300000,India,1600000,34500,1000,1635500
TeremokSongs,–¢–µ—Ä–µ–º–æ–∫ - –ü–µ—Å–µ–Ω–∫–∏ –¥–ª—è –¥–µ—Ç–µ–π,Music & Dance,9300000,Russia,115400,615,0,116015
YFrostA,FROST,Video games,9300000,Russia,560500,48500,1800,610800
RSVDO,rsfriends,Music & Dance,9300000,Thailand,4400,118,12,4530
LetDa Hyper,LetDa Hyper,Music & Dance,9300000,Indonesia,95000,5200,332,100532
brunoberti10,Irm√£os Berti,Toys,9300000,Brazil,116300,7000,194,123494
Karina Garcia,Karina Garcia,DIY & Life Hacks,9300000,United States,220800,9200,301,230301
PlaticaPolinesa,PlaticaPolinesia,Music & Dance,9300000,Mexico,38500,3900,370,42770
FoxNewsChannel,Fox News,News & Politics,9300000,United States,207100,5100,1800,214000
RoosterTeeth,Rooster Teeth,Movies,9300000,United States,40800,1300,136,42236
Soothing Relaxation,Soothing Relaxation,Music & Dance,9200000,United States,112300,3600,258,116158
NFL,NFL,Sports,9200000,United States,107300,1800,206,109306
Troom Troom SELECT,Troom Troom SELECT,Movies,9200000,United States,342700,4000,93,346793
chetakvideo,Chetak,Music & Dance,9200000,India,15600,308,10,15918
Denis,Denis,Video games,9200000,United States,194200,9100,461,203761
FutPar√≥dias,FutPar√≥dias,Music & Dance,9200000,Brazil,1400000,110100,2500,1512600
EL GATO,EL GATO,Toys,9200000,Brazil,243800,30700,636,275136
CinemaSins,CinemaSins,Movies,9200000,United States,296000,10200,874,307074
CricketICC,ICC,Sports,9200000,India,15200,854,58,16112
BRKsEDU,BRKsEDU,Animation,9200000,Brazil,112300,9800,246,122346
